#####TTTT#######TTTTTTTTTTTTTTTT[~~]TTTTTTTTTTTTT[~]TTTTTTTTTTTTTTTTTTTTTTTTTTTTTTTT
T###TTTTTT#####TTTTTTTT######TTW[~~]####..TT...............#TTTTTTTTTTTTTTTTTTTTTTTT
TTTTTTWTTTTTTTTTTTTWTTTT#####T..[~~]####..TTTTTTTTTTTTTTT..##TTTTTTTTTTTTTTTTTTTTTTT
TTTTT...TDTTTTTTTT...TTTTTTTT...[~~]####..TTT####E####TTT..###TTTTTTTTTTTTTTTTTTTTTT
T.P.............................[~~].......................~~~~~~~~.............TTTT
T...............................[~~].......................~~~~~~~~.............TTTT
TTTTTTTTTTTTTTTTTT...TTTTTTTT...[~~]####..TTT####E####TTT..###TTTTTTTTTTTTTTTTTTTTTT
TTTTTTTTTTTTTTTTTTTWTTTT#####T..[~~]####..TTTTTTTTTTTTTTT..##TTTTTTTTTTTTTTTTTTTTTTT
T#####TTTT#####TTTTTTTT######TTW[~~]####..TT##.............#TTTTTTTTTTTTTTTTTTTTTTTT
#######TT#######TTTTTTTTTTTTTTTT[~~]TTTTTTTTTTTTT#B##.#TTTTTTTTTTTTTTTTTTTTTTTTTTTTT
TTTTTTTTTTTTTTTTTTTTTTTTTTTTTTTTTTTTTTTTTTTTTTTTT[~]T.TTTTTTTTTTTTTTTTTTTTTTTTTTTTTT
T#####TTTT#####TTTTTTTTTTTTTTTTTTTTTTTTTTTTTTTTTT[~]T.TTTTTTTTTTTTTTTTTTTTTTTTTTTTTT
#######TT#######TTTTTTTTTTTTTTTTTTTTTTTTTTTTTTTTT[~]T.TTTTTTTTTTTTTTTTTTTTTTTTTTTTTT
TTTTTTTTTTTTTTTTTTTTTTTTTTTTTTTTTTTTTTTTTTTTTTTTT[~]T.TTTTTTTTTTTTTTTTTTTTTTTTTTTTTT
T#####TTTT#####TTTTTTTTTTTTTTTTTTTTTTTTTTTTTTTTTT[~]T.TTTTTTTTTTTTTTTTTTTTTTTTTTTTTT
#######TT#######TTTTTTTTTTTTTTTTTTTTTTTTTTTTTTTTT[~]T.TTTTTTTTTTTTTTTTTTTTTTTTTTTTTT
TTTTTTTTTTTTTTTTTTTTTTTTTTTTTTTTTTTTTTTTTTTTTTTTT[~]T.TTTTTTTTTTTTTTTTTTTTTTTTTTTTTT
TTTTTTTTTTTTTTTTTTTTTTTTTTTTTTTTTTTTTTTTTTTTTTTTT[~]T.TTTTTTTTTTTTTTTTTTTTTTTTTTTTTT
TTT...................T...............TTTTTTTTTTT[~]T.TTTTTTTTTTTTTTTTTTTTTTTTTTTTTT
TTT...................T................TTTTTTTTTTT.TT.TTTTTTTTTTTTTTTTTTTTTTTTTTTTTT
TTT..TTTTTTTTTTTTTTTTTT#....TTTTTTT....TTTTTTTTTT...T.TTTTTTTTTTTTTTTTTTTTTTTTTTTTTT
TTT..TTTTTTTTTTTTTTTTTS....TTTTTTTTT...TTTTTSTTTT.....TTTTTTTTTTTTTTTTTTTTTTTTTTTTTT
TTT..TTTTTTTTTTTTTTTTTT#..TTTT###TTTT..TTTT...TTT...TTTTTTTTTTTTTTTTTTTTTTTTTTTTTTTT
TTT..TTTTTTTTTTTTTTTTTTTTTTTT#####TTT..TTT.....TT...TTTTTTTTTTTTTTTTTTTTTTTTTTTTTTTT
TTT....................TTTTTTTTTTTTTT...............TTTTTTTTTTTTTTTTTTTTTTTTTTTTTTTT
TTT....................TTTTTTTTTTTTTT...............TTTTTTTTTTTTTTTTTTTTTTTTTTTTTTTT
TTTTTTTTTTTTTTTTTTTTTTTTTTTTTTTTTTTTTTTTTTTTTTTTTTTTTTTTTTTTTTTTTTTTTTTTTTTTTTTTTTTT