TTTTTTTTTTTTTTTTTTT
T###TTTTTT#####TTTT
TTTTTT.TTTTTTTTTTTT
TTTTT...#####TTTTTT
TT.................
TTTTT...#####TTTTTT
T###TT.TTTTTTTTTTTT
T###T...TTTTTTTTTTT
T###T...TTTTTTTTTTT
T###T...TTTTTTTTTTT
T###T.P.TTTTTTTTTTT
T###TTTTTTTTTTTTTTT
===
